10 15
5 2
1 1 1 1 1 1 1 0 0 0 0 0 0 0 0
1 0 0 2 3 0 1 0 0 0 0 0 0 0 0
1 0 1 0 1 0 1 0 0 0 0 0 0 0 0
1 0 0 2 0 0 1 0 0 0 0 0 0 0 0
1 0 1 0 1 3 1 0 0 0 0 0 0 0 0
1 0 0 4 0 0 1 0 0 0 0 0 0 0 0
1 1 1 1 1 1 1 0 0 0 0 0 0 0 0
0 0 0 0 0 0 0 0 0 0 0 0 0 0 0
0 0 0 0 0 0 0 0 0 0 0 0 0 0 0
0 0 0 0 0 0 0 0 0 0 0 0 0 0 0